    #####
    #   #
    #X  #
  ###  X###
  #  X  X #
### # ### #     ######
#   # ### #######   O#
# X  X      P       O#
##### #### # ####  OO#
    #      ###  ######
    ########
